t . . . . . . .
t . c . . . . t
t . . . . . . .
. . . . . t . .
. . . . p s t .
. . . . . t . t
. . . . . . . t
t . . . . . . .