. . . . . . . .
. c . . . . . .
. . . . . . . .
. . . . . t t .
. . . . p s t .
. . . . . t t .
. . . . . . . .
. . . . . . . .