s s s s s s s s
. . . . . . . .
. . . . . . . .
. . p p p . . .
. . p c p p p .
. . . . . p . .
. . . . . . . .
. . . . . . . .