. . . . . . . .
. . . . . . . .
. . s . s . s .
. . . p p p . .
. . s p c p s .
. . . p p p . .
. . s . s . s .
. . . . . . . .